15 20
BBBBBBBBBBBBBBSSTSSS
B.h.hIBmm.t.mmSC...S
B.ye..D.......D....X
B..m..B.y...y.S.p..S
B.m.mtB.P...P.St...S
BBBBBBBVYWDWWVSSTSSS
B.bh.b.V.M..M.V.c..V
B.g..f.D..z...D..y.V
Baey.g.V..e...W...cV
B..e...V.gr.mmYs.mmV
BBBDBBBVVWYWYVWSSSSS
Bg...e.V.f..e.S...zX
Bg.y...D..y...D.H..S
B.et.e.V.K.gK.SL...S
BBBBBBBBBBBBBBSSSSSS