######
#   e#
#    #
#    #
# X  #
######