20 21
SSSSWWWWWWWWSSSSSSSSS
S......W............S
S..SWdWWWdWSSS......S
S..S.......S..e.....S
S..S..o....d........S
S..S.......S........S
SSSSSSdSSSSSS...SSSSS
S..S.......S....SXS.S
S..S.......S....SdS.S
S..S.......d........S
S..d.e.....S....g...S
S..S.......S........S
SSSSSS...SSSSSSSSSSSS
S....S.........B....S
S....d.......h.B....S
S.p..S...k.....d....S
S....S.......B.B....S
S....BBBBdBBBBBB....S
S....B......B.......S
SBBBBBBBBBBBBBSSSSSSS