20 21
   WWWWWWWWW SSSSSSSS
   W...W...W S......S
   SWdWWWdWSSS...o..S
   S.......S..e.....S
   S.gg....d........S
   S.......S........S
SSSSSSdSSSSSS...SSSSS
S..S.......W....SXS.S
Sh.S.h.....W....SdS.S
S..d.......d........S
SSSS.e.....W....g...S
   S.......W........S
SSSSSS...SSSSSSSSSSSS
S....S.........S....S
S.o..d.......h.S.hh.S
S.p..S...k.o...d....S
S....S.........SSSSSS
S.o..SBBBdBBBBBB    .
SSSSSSB.mm..B       .
      BBBBBBB       .