7 8
########
#.#..e.#
#......#
#......#
####.###
#.X....#
########